00100000000000000000011110010011
00011101100000000010111110000011
00000001111101111010100000100011
00011101110000000010111110000011
00000001111101111010101000100011
00011110000000000010111110000011
00000001111101111010110000100011
00011110010000000010111110000011
00000001111101111010111000100011
00011110100000000010111110000011
00000011111101111010000000100011
00000000111101010000000100010011
00000000000100001000000010010011
11111110001000001100110011100011
00000001110001111000001010110011
00011001100000000000001100010011
00000000001000000000001000010011
00011001010000000010000110000011
00000000011000000000001110110011
00000000111100000000101110110011
00000000000000111010111110000011
00000001111110111010000000100011
00000000010010111000101110010011
00000000010000111000001110010011
11111110010110111100100011100011
00000000000011111000101010010011
00000001000000000000101100010011
00000001011010101000101010110011
00000011110001111000101110010011
00000001010110111010000000100011
00011001000000000010010100000011
11111110000001010000111011100011
00000001000001010000100001100011
00000011000101010000001001100011
00000011001001010000110001100011
00000101001101010000101001100011
00000000000010111010110110000011
01000001011011011000110110110011
00000000010010110001101100110011
00000001010110110000110110110011
00000001101110111010000000100011
00000100000000000000111001100011
00000000000010111010110110000011
01000001011011011000110110110011
00000000010010110101101100110011
00000001010110110000110000110011
00000001100010111010000000100011
00000100000000000000001001100011
00000000000010111010110110000011
01000001011011011000110110110011
11111111110010111000101110010011
00000000000010111010101010000011
00000001011010101000101010110011
00000001101110111010001000100011
00000001010110111010000000100011
00000010000000000000001001100011
00000000000010111010110110000011
01000001011011011000110110110011
00000000010010111000101110010011
00000000000010111010101010000011
00000001011010101000101010110011
11111111101110111010111000100011
00000001010110111010000000100011
00000000001110101000011001100011
00011110000000000010111000100011
11110110000000000000101011100011
00000000111100000000101110110011
00000000000010111010000000100011
00000000010010111000101110010011
11111110010110111100110011100011
00011110110000000010111110000011
00000001111101111010100000100011
00011111000000000010111110000011
00000001111101111010101000100011
00011111010000000010111110000011
00000001111101111010110000100011
00011111100000000010111110000011
00000001111101111010111000100011
00011111110000000010111110000011
00000011111101111010000000100011
11111100000000000000010011100011